Wo, Wo, Wo, Wo, Wo, Wo, Wo, Wo, Wo, Wo, Ms, Ms, Ms, Mm, Ms, Mm, Ms, Mm, Ms, Ms, Ms, Aa^Fma, Aa^Fma, Aa^Fma, Aa^Fma, Aa^Fma, Ms, Gg, Mm, Gg, Mm, Gg, Mm, Mm, Mm, Gg, Mm, Mm, Rb, Mm, Rb, Mm, Rb, Mm, Mm, Mm, Mm, Mm, Mm, Gg, Mm, Gg, Hh, Gg, Hh, Wo, Gg, Gg, Aa^Fma, Gg, Mm, Gg
Wo, Wo, Wo, Wo, Wo, Wo, Wo, Gg, Wo, Gll^Fp, Ms, Ms, Ms, Ms, Ms, Ms, Ms, Ms, Ms, Ms, Ms, Ms, Wo, Aa^Fma, Wwg, Wwg, Aa^Fma, Ms, Ms, Mm, Ms, Ms, Ms, Mm, Mm, Mm, Rb, Rb, Rb, Rb, Rr, Rb, Rr, Rr, Rr, Gg, Gg, Mm, Mm, Mm, Mm, Mm, Hh, Hh, Wo, Wo, Aa^Fma, Aa^Fma, Aa^Fma, Aa^Fma, Mm, Mm
Wo, Wo, Wo, Wo, Wo, Wo, Wo, Wo, Gll^Fp, Aa^Fma, Ms, Rrc^Vhca, Wwg, Ms, Mm^Esa, Ms, Ms, Ms, Aa^Fma, Ms, Wwg, Wo, Gs^Fds, Wwg, Gg, Aa^Fma, Aa^Fma, Aa^Fma, Rr^Vhc, Aa^Fma, Gg, Mm, Ms, Mm, Rb, Rb, Rr, Rb, Rr, Rr, Gg, Rr, Wwg, Hhd^Vhhr, Gg, Rr, Rr, Gg, Rr, Gg, Gg, Hh, Gg, Wo, Ss, Aa^Fma, Aa^Fma, Aa^Fma, Wo, Gg, Wo, Wo
Wo, Wo, Wo, Wo, Wo, Wo, Wo, Ms, Gll^Fp, Gll^Fp, Ms, Rr, Rr, Wwg, Wo, Ms, Wo, Wo, Wwg, Gg^Esa, Wwg, Gg, Gg^Esa, Gg, Gg, Gg, Gg^Esa, Gg, Rr, Gg^Esa, Rr, Gg, Rr, Gg, Rr, Rr, Gg, Rr, Wo, Ww, Wo, Wwg, Mm, Mm, Mm, Rb, Rb, Rr, Gg, Rr, Rr, Gg, Hh^Vhh, Wo, Ss, Aa^Fma, Wo, Wo, Rd, Wo, Gg^Fp, Mm
Wo, Wo, Wo, Wo, Wo, Wo, Wo, Gg, Gg, Gll^Fp, Wwg, Mm, Mm^Esa, Rr, Rr, Wo, Rr, Gg, Wo, Wo, Gg, Gg, Rr, Rr, Rr, Gg^Esa, Rr, Rr, Gg^Esa, Rr, Rb, Rr, Gg, Rr, Gg, Rb, Rb, Wo, Rr, Gg, Gg, Mm, Mm, Mm, Mm, Mm, Mm, Gg, Mm, Hh, Rr, Rr, Gg, Wo, Wo, Wo, Rd, Rd, Rd^Edt, Rd^Fp, Gg^Fp, Mm
Wo, Wo, Wo, Wo, Wo, Wo, Mm, Ai, Ai, Wo, Wo, Wwg, Gll^Fp, Ms, Mm^Esa, Rr, Ms, Rr, Wo^Bw\r, Cha, 6 Kha^Vov, Cha, Gg, Gg, Gg, Rr, Rr, Gg, Gg, Gs^Fds, Gs, Rb, Gg, Rr, Gg, Rb, Rr, Wwg^Bw/, Gg, Rr, Rr, Gs^Fds, Mm, Mm, Mm, Mm, Mm, Mm, Gg, Rr, Gg, Gg, Gg, Wwg, Gg, Gg^Em, Hh, Rd^Edt, Chr^Edt, Mm, Chr^Dr, Mm
Wo, Wo, Wo, Wo, Wo, Wo, Mm, Mm, Wo, Wo, Wo, Wo, Gll^Fp, Gll^Fp, Wwg, Mm, Ms, Gg, Wo, Cha, Cha, Gg, Gg^Esa, Gg^Esa, Wwg, Gg, Gg, Rr, Gg, Gs^Fds, Gs^Fds, Rb, Gg, Cha, Cha, Rr, Gg, Wwg, Gg, Gg, Rr, Gs^Fds, Gg, Mm, Mm, Mm, Mm, Mm, Gg, Rr, Gg, Ss, Wo, Wwg, Gg^Em, Gs^Fds, Rd, Hh^Dr, Chr, 5 Khr^Vov, Chr, Mm
Wo, Wo, Wo, Wo, Wo, Wo, Ai, Wo, Wo, Wo, Wo, Mm, Mm, Gg^Fp, Wwg, Aa, Ms, Aa, Gg^Esa, Ai, Ai, Wo, Wo, Wwg, Gg, Gg, Gg, Rr, Gg, Rb, Rb, Rb, Gg, Kha^Vov, Gg, Gg, Gg, Wo, Gs^Fds, Gs^Fds, Gg, Rr, Rr, Mm, Gg, Mm, Hh, Hh, Gg, Rr, Gg, Ss, Wo, Ss, Gs^Fds, Gs^Fds, Rp, Rp, Hh^Dr, Mm, Rd^Edt, Mm
Wo, Wo, Wo, Wo, Koa, Ai, Wo, Wo, Wo, Wo, Wo, Gg, Aa, Gg^Fp, Wo, Aa, Ms, Aa, Gg^Esa, Rra, Wo, Wo, Wo, Gg, Gs^Fds, Gg, Gg, Rr, Rr, Gg, Wwg, Wo, Wo, Cha, Wo, Gg, Wo, Wo, Gg, Mm, Mm, Mm, Gg, Rr, Rr, Gg, Hh, Hh, Gg, Rr, Gg, Wo, Gg, Gg^Em, Rp, Gs^Fds, Gs^Fds, Rd, Rd, Mm, Mm, Mm
Wo, Wo, Wo, Wo, Mm, Coa, Gll^Fp, Wo, Wo, Wo, Ms, Wo, Wo, Wo, Aa, Aa, Gg^Fp, Mm, Mm, Rra, Gg, Wo, Wo, Gg, Gg^Em, Gs^Fds, Gg, Gg, Wwg, Wwg^Bw\, Rr, Gg, Gg, Wwg, Gg, Wo, Gg, Gs^Fds, Mm, Mm, Ss, Mm, Gg, Gg, Hh, Rr, Gg, Gg, Gg^Vhc, Rr, Wo, Wo, Wwg, Rp, Wo, Wo, Wo, Wo, Wwg, Wwg, Gg, Mm
Wo, Wo, Wo, Wo, Wo, Mm, Gg^Fp, Ai, Ai, Wo, Gg^Fp, Ms, Wwg, Mm, Mm, Gg^Fp, Gg^Fp, Gg^Fp, Gg, Rra, Gg, Wo, Wo, Rb, Rb, Mm, Wo, Wo, Gg, Gg, Rr, Gg, Ss, Ss, Gg, Gg, Hh, Mm, Gg, Ss, Wo, Wo, Wo, Wo, Wo, Wwg^Bw|, Wwg, Wo, Wwg, Wwg^Bw|, Rp, Rp, Ss, Wwg, Gs^Fds, Ss, Gg, Gg, Gg^Fp, Mm, Mm, Mm
Wo, Wo, Wo, Wo, Wo, Wo, Wo, Wo, Wo, Wwg, Gg^Fp, Gg^Fp, Ai, Ai, Wo, Gg, Gg, Gg^Fp, Wo, Rrc^Vhca, Wo, Wo, Mm, Rb, Wo, Wo, Gg, Gg^Em, Gs^Fds, Gg, Rr, Gg, Gg, Ss, Hh, Hh, Hh, Hh, Gg, Wo, Gg, Gg, Gg, Gg, Gg, Rr, Rr, Gg, Gg, Rr, Gg, Ss, Gg^Em, Gs^Fds, Gg, Gg, Gg^Fp, Gg^Fp, Mm, Mm, Mm, Mm
Wo, Wo, Wo, Wo, Wo, Wo, Wo, Wo, Wo, Wo, Wo, Wo, Wo, Wo, Wo, Wo, Mm, Gg, Wo, Wo, Wo, Wo, Wo, Wo, Wo, Wo, Wo, Gs^Fds, Gs^Fds, Gg, Rr, Gg^Wm, Gs^Fds, Gg, Gs^Fds, Gg, Gg, Gg, Gg, Wo, Ss, Gg^Em, Kud, Mm, Mm, Ss, Ss, Rr, Rr, Rr, Rr, Gg, Gs^Fds, Gg, Gg^Em, Gg, Gg^Fp, Gg^Fp, Gg^Fp, Mm, Mm, Mm
Wo, Wo, Wo, Wo, Wo, Wo, Wo, Wo, Wo, Wo, Mm, Gll^Fp, Wo, Wo, Wo, Wo, Mm, Gg, Wo, Wo, Wo, Wo, Wo, Wo, Wo, Wo, Wo, Wo, Gg, Gg, Rr, Gg, Gg^Em, Gs^Fds, Hh, Gs^Fds, Gs^Fds, Gg, Gg, Wo, Ss, Gg^Em, Cud, Mm, Mm, Mm, Mm, Gg, Gg^Em, Gg, Rr, Gg, Gs^Fds, Gs^Fds, Gg, Gd, Gd, Gg^Fp, Gg^Fp, Gg^Fp, Gg^Fp, Mm
Wo, Wo, Wo, Wo, Wo, Wo, Wo, Wo, Wo, Wo, Wo, Gll^Fp, Wo, Wo, Wo, Wo, Wo, Wo, Wo, Wo, Wo, Wo, Wo, Wo, Wo, Wo, Wo, Wo, Hh, Gg, Rr, Gg, Gg, Gs^Fds, Gs^Fds, Gs^Fds, Gg^Em, Gg, Gg, Wo, Ss, Gg, Hh^Fp, Mm, Mm, Mm, Mm, Gg, Hh, Gg, Gg, Rr, Gg, Gs^Fds, Gg, Gd, Gg, Gd, Gd, Gg^Fp, Gg, Mm
Wo, Wo, Wo, Wo, Wo, Wo, Wo, Wo, Wo, Wo, Wo, Wo, Wo, Wo, Wo, Wo, Wo, Wo, Wo, Wo, Wo, Wo, Wo, Wo, Wo, Wo, Wo, Wo, Gg, Hh, Rr, Gg, Gg, Gg, Gg, Hh, Wo, Wo, Wo, Wo, Gg, Gg^Fp, Hh^Fp, Gg^Fp, Mm, Mm, Gg, Hh^Fp, Hh^Fp, Hh, Ss, Rr, Rr, Gg, Gg, Ch, Kh^Vov, Gg, Gg, Gg, Wo, Wo
Wo, Wo, Wo, Wo, Wo, Wo, Wo, Wo, Wo, Wo, Wo, Wo, Wo, Wo, Wo, Wo, Wo, Wo, Wo, Wo, Wo, Wo, Wo, Wo, Wo, Wo, Wo, Wo, Hh, Hh, Rr, Rr^Vhc, Gg, Hh, Wo, Wo, Gs, Gs, Gg, Gg, Gg^Fp, Gg^Fp, Gg^Fp, Gg^Fp, Gs, Mm, Mm, Hh^Fp, Gg^Fp, Hh^Fp, Gg^Fp, Ss, Rr, Gg, Rr, Ch, Ch, Ch, Wo, Wo, Gg, Mm
Wo, Wo, Wo, Wo, Wo, Wo, Wo, Wo, Wo, Wo, Wo, Wo, Wo, Wo, Wo, Wo, Wo, Wo, Wo, Wo, Wo, Wo, Gg, Gg, Gg, Hh, Gg^Em, Wo, Wo, Gg, Wwg^Bw|, Gg, Wwg, Wo, Gg, Gg, Rr, Ss, Rr, Gs^Vl, Rr, Gg, Gg, Gs, Rr, Gs, Gg, Gg, Gg, Gg^Fp, Rr, Gg, Rr, Gg, Rr, Gg, Gg, Wo, Mm, Gg, Mm, Mm
Wo, Wo, Wo, Wo, Wo, Wo, Wo, Wo, Wo, Wo, Wo, Wo, Wo, Wo, Wo, Wo, Wo, Wo, Wo, Wo, Gg, Hh, Hh, Gg, Gs^Fds, Gs^Fds, Gs^Fds, Gs^Fds, Gg^Em, Wo, Rr, Wwg, Gg, Gg, Rr, Rr, Gs, Rr, Gg, Rr, Gg, Rr, Rr, Rr, Gg^Fp, Rr, Rr, Rr, Rr, Rr, Gg^Fp, Rr, Rr^Vhc, Rr, Gg, Gg, Gg, Wo, Mm, Mm, Mm, Mm
Wo, Wo, Wo, Wo, Wo, Wo, Wo, Wo, Wo, Wo, Wo, Wo, Wo, Wo, Wo, Wo, Wo, Wo, Wo, Wo, Wo, Hh, Wo, Gg, Gg, Gg, Gg^Em, Hh, Gg, Gg, Rr, Rr, Rr, Rr, Hh, Hh, Wo, Gs, Wwg, Gg, Mm, Gg, Mm, Gs, Gg^Fp, Gg^Fp, Mm, Gg, Hh^Fp, Gg^Fp, Gg^Fp, Gg, Gg, Rr, Gs^Fds, Gs^Fds, Gg, Wo, Gs^Fds, Mm, Mm, Mm
Wo, Wo, Wo, Wo, Wo, Wo, Wo, Wo, Wo, Wo, Wo, Wo, Wo, Wo, Wo, Wo, Wo, Wo, Wo, Wo, Wo, Wo, Wo, Wo, Wo, Gg, Gg, Gg, Gg, Gg, Rr, Gg, Gg, Gg, Wo, Wo, Gg, Wwg, Gg, Gg, Gg, Mm, Mm, Mm, Gg^Fp, Hh, Mm, Mm, Hh, Gg^Fp, Gg, Gg, Rr, Rr, Rr, Gs^Fds, Gg, Wo, Gs^Fds, Uu^Vud, Gg, Mm
Wo, Wo, Wo, Wo, Wo, Wo, Wo, Wo, Wo, Wo, Wo, Wo, Wo, Wo, Wo, Wo, Wo, Wo, Wo, Wo, Wo, Wo, Wo, Wo, Wo, Gg, Gg, Rr^Vhc, Rr, Rr, Gs^Fds, Gs^Fds, Gg, Wo, Gg, Gg, Gs^Fds, Gs^Fds, Gs^Fds, Gs^Fds, Gg, Mm, Mm, Mm, Mm, Mm, Mm, Hh, Hh, Gg, Rr, Rr, Gg, Gg, Rr, Gg, Gg, Wwg, Rr, Rr, Gg, Mm
Wo, Wo, Wo, Wo, Wo, Wo, Wo, Wo, Wo, Wo, Wo, Wo, Wo, Wo, Wo, Wo, Wo, Wo, Wo, Wo, Wo, Wo, Wo, Wo, Wo, Hh, Hh, Rr, Gg, Gg, Hh, Gs^Fds, Gg, Wo, Gg, Gg, Gs^Fds, Gs^Fds, Gs^Fds, Gg, Mm, Mm, Mm, Mm, Gg, Rr^Vd, Gg, Gg, Rr, Rr, Mm, Gg, Gg, Gg, Cvr, Rr, Rr, Wwg^Bw/, Gg, Gg, Mm, Mm
Wo, Wo, Wo, Wo, Wo, Wo, Wo, Wo, Wo, Wo, Wo, Wo, Wo, Wo, Wo, Wo, Wo, Wo, Wo, Wo, Wo, Wo, Wo, Wo, Wo, Gg, Gg, Rr, Wwg, Gg, Gg, Gg, Wo, Wo, Wo, Wo, Wo, Gs^Fds, Wwg, Wwg, Gs^Fds, Gg^Fp, Gg^Fp, Gg^Fp, Gg^Fp, Gg^Fp, Gg, Rr, Gg, Gg, Mm, Mm, Gs^Fds, Gs^Fds, Ss, Rr, Ss, Wo, Gg^Fp, Gg, Mm, Mm
Wo, Wo, Wo, Wo, Wo, Wo, Wo, Wo, Wo, Wo, Wo, Wo, Wo, Wo, Wo, Wo, Wo, Wo, Wo, Wo, Wo, Wo, Wo, Wo, Wo, Wo, Wo, Wwg^Bw|, Gg, Wo, Wo, Wo, Gg, Gg, Gg^Wm, Gg, Gg, Wo, Gg, Gg, Gs^Fds, Gs^Fds, Gg^Fp, Gg^Fp, Gg^Fp, Gg^Fp, Gg, Rr, Gg, Hh, Mm^Fp, Hh, Gs^Fds, Gg, Rr, Rr, Wo, Wo, Gg^Fp, Gg^Fp, Mm, Mm
Wo, Wo, Wo, Wo, Wo, Wo, Wo, Wo, Wo, Wo, Wo, Wo, Wo, Wo, Wo, Wo, Wo, Wo, Wo, Wo, Wo, Wo, Wo, Wo, Gg, Gg, Gg, Rr, Rr, Gg, Gg, Gg, Gg, Gg^Gvs, Gg^Gvs, Gg, Gg, Gg, Gs^Fds, Gg, Gg, Gs^Fds, Gs^Fds, Gg, Gg, Gg, Rr, Rr, Gs^Fds, Hh^Fp, Hh^Fp, Hh^Fp, Rr, Rr, Gg, Wo, Gs^Fds, Gg^Fp, Gg^Fp, Gg^Fp, Mm, Mm
Wo, Wo, Wo, Wo, Wo, Wo, Wo, Wo, Wo, Wo, Wo, Wo, Wo, Wo, Wo, Wo, Wo, Wo, Wo, Wo, Wo, Wo, Gg, Chw, Kh^Vov, Gg, Rr, Rr, Gg, Rr, Rr, Gg, Ch, Gg, Gg, Gg, Gg, Gs^Fds, Gs^Fds, Gs^Fds, Hh, Hh, Gg, Gg, Rr^Vhc, Gg, Rr, Gg, Ss, Gs^Fds, Gs^Fds, Gg, Rr, Gg, Wo, Wo, Gs^Fds, Gg^Fp, Gg^Fp, Gg^Fp, Mm, Mm
Wo, Wo, Wo, Wo, Wo, Wo, Wo, Wo, Wo, Wo, Wo, Wo, Wo, Wo, Wo, Wo, Wo, Wo, Wo, Wo, Wo, Wo, Wo, Chw, Ch, Ch, Rr, Gg, Gg^Gvs, Gg^Gvs, Gg^Gvs, Rr, Ch, Kh^Vov, Ch, Gg, Gg, Gg, Gg^Gvs, Gg^Gvs, Gg^Gvs, Hh, Rr, Rr, Rr, Rr, Gg, Rr, Gg, Gg, Gg, Rr, Gg, Gg, Wo, Gg, Ss, Gs^Fds, Cvr, Gg^Fp, Mm, Mm
Wo, Wo, Wo, Wo, Wo, Wo, Wo, Wo, Wo, Wo, Wo, Wo, Wo, Wo, Wo, Wo, Wo, Wo, Wo, Wo, Wo, Wo, Wo, Ww, Ww, Ww, Rr, Gg, Ss, Gg^Gvs, Gg, Gg, Gg, Ch, Gg, Rr, Rr, Gg, Gg, Gg^Gvs, Rr, Rr, Gg, Gg, Gs^Fds, Gg, Ss, Rr, Gg, Rr^Vhc, Rr, Rr, Gs^Fds, Gs^Fds, Wo, Ss, Ww, Ww^Ewf, Ww^Ewf, Ww^Ewf, Wo, Wo
Wo, Wo, Wo, Wo, Wo, Wo, Wo, Wo, Wo, Wo, Wo, Wo, Wo, Wo, Wo, Wo, Wo, Wo, Wo, Wo, Wo, Wo, Hh, Wo, Wo, Wo, Wo^Bsb|, Ww, Ww, Ss, Rr, Rr, Rr, Rr, Gg, Gg, Rr, Gg, Rr^Vhc, Rr, Gg, Hh, Gg, Gs^Fds, Gs^Fds, Gs^Fds, Gg, Rr, Rr, Rr, Rr, Gs^Fds, Ss, Ww, Wo, Ww, Wo, Wo, Wo, Ww, Mm, Mm
Wo, Wo, Wo, Wo, Wo, Wo, Wo, Wo, Wo, Wo, Wo, Wo, Wo, Wo, Wo, Wo, Wo, Wo, Wo, Wo, Gs^Fms, Gg, Gg, Gg, Gg, Gg, Rrc, Wo, Rr, Rr, Gg, Gg, Gg, Gg, Gg, Gg, Gg, Rr, Rr, Rr, Gg, Hh, Ww, Gg, Ww, Ss, Ss, Hh, Gg, Gg, Ww, Rr, Wo^Bw\, Wo, Gg, Wo, Hhd^Efm, Gg^Efm, Cvr^Efm, Wo, Mm, Mm
Wo, Wo, Wo, Wo, Wo, Wo, Wo, Wo, Wo, Wo, Wo, Wo, Wo, Wo, Wo, Wo, Ds, Cv, Ds, Ww, Hh, Hh, Gs^Fms, Gs^Fms, Gg, Gg^Ve, Rrc, Wo^Bsb/, Ww, Ww, Ww^Ewf, Ww^Ewf, Ww, Ww^Ewf, Ww^Ewf, Gg, Ww, Gg, Rr, Gg, Ww, Ww, Wo, Ww, Wo, Ww, Ww, Hh, Ww^Ewf, Ww^Ewf, Wo, Wo, Gg^Em, Rr, Rr, Gg^Efm, Hhd^Efm, Hhd^Efm, Gg^Efm, 4 Kvr^Vov, Gg^Efm, Mm
Wo, Wo, Wo, Wo, Wo, Wo, Wo, Wo, Wo, Wo, Wo, Wo, Wo, Wo, Wo, Wo, Cv, Kv^Vov, Cv, Ww, Hh, Hh, Gg^Em, Gs^Fms, Gg, Rrc, Gg, Wo, Wo, Wo, Wo, Wo, Wo, Wo, Wo, Ww, Wo, Ww, Wo^Bw|, Ww, Wo, Wo, Gg, Wo, Gg, Wo, Wo, Ww, Wo, Wo, Wo, Gg^Em, Rr, Rr^Efm, Gg^Efm, Rr^Efm, Gg^Efm, Gg^Efm, Gg^Efm, Cvr^Efm, Hhd, Gg
Wo, Wo, Wo, Wo, Wo, Wo, Wo, Wo, Wo, Wo, Wo, Wo, Wo, Wo, Wo, Wo, Wo, Ds, Ww, Wo^Bsb\, Rr, Gs^Fms, Gg, Gg, Gg, Rr, Gg, Wo, Ss, Ss, Gg, Gg, Gg, Gg, Gg, Wo, Gg, Wo, Rr, Wo, Ss, Ss, Rr, Rr^Vhc, Gg, Gg, Gg, Wo, Ss, Ss, Rr, Ww^Bw/, Ww, Gg^Efm, Gg^Efm, Rr^Efm, Ww, Gg^Em, Hhd^Efm, Hhd^Efm, Gg, Gg
Wo, Wo, Wo, Wo, Wo, Wo, Wo, Wo, Wo, Wo, Wo, Wo, Wo, Mm, Wo, Wo, Wo, Ww, Wo, Wo, Wo, Rr, Rr, Gs^Fms, Gg, Rr, Gg, Wo, Wo, Ss, Gg, Gs^Fds, Hh^Fds, Hh^Fds, Gg^Gvs, Gg^Gvs, Rr, Rr, Rr, Gg, Rr, Rr, Gg, Rr, Rr, Rr, Rr, Rr, Rr, Rr, Gg, Gg, Wo, Gg, Ww, Ww^Bw|, Gg, Wo, Wo, Wo, Wo, Wo
Wo, Wo, Wo, Wo, Wo, Wo, Wo, Wo, Wo, Wo, Wo, Wo, Wo, Wo, Gg, Wo, Mm, Wo, Gg, Gg, Ss, Wo, Gg, Rr, Rr, Rr, Gg, Gg, Gg, Wo, Wo, Gs^Fds, Gs^Fds, Gg, Rr, Rr, Gg, Gg, Gg, Rr, Ss, Ss, Hh, Hh, Hh^Fds, Gg, Gg, Gg, Rr, Gg, Rr^Vd, Gg, Gg, Wo, Gg, Rr, Gg, Gg, Gg, Gg, Gg, Gg
Wo, Wo, Wo, Wo, Wo, Wo, Wo, Wo, Mm, Wo, Wo, Wo, Chw, Gg, Ch, Gg, Gg, Mm, Gg, Gg, Rr, Ss, Gg, Rr, Rr^Vhc, Gg, Gd^Gvs, Gg^Gvs, Gg, Ss, Wo, Ss, Gg, Gg, Ch, Gg, Gg, Hh^Fds, Gg, Gg, Hh^Fds, Gg, Hh^Fds, Hh^Fds, Hh, Hh^Fds, Rr, Rr, Mm, Gg, Hh, Gs^Fds, Gg, Wo, Gg, Rr, Rr, Gg, Gg, Rr^Vhc, Gg, Gg
Wo, Wo, Wo, Wo, Wo, Wo, Wo, Wo, Wo, Wo, Gg, Gg, Gg, Kh^Vov, Ch, Gg, Rr, Gg, Rr, Rr, Gg, Rr, Rr, Rr, Rr, Gg, Gd^Gvs, Gg^Gvs, Ss, Gg, Wwg, Gg, Rr, Ch, Kh^Vov, Wwg, Wwg, Gg, Wo, Gg, Ss, Gg, Gg, Hh, Rr, Rr, Gs^Vh, Mm, Mm, Mm, Hh, Mm^Fds, Gs^Fds, Wo, Gg, Gg, Ch, Gg, Rr, Rr, Gg, Gg
Wo, Wo, Wo, Wo, Wo, Wo, Wo, Wo, Mm, Mm, Rr, Gg, Gg, Ch, Rr, Rr, Gg, Rr, Gg, Gs^Fms, Gs^Fms, Gs^Fms, Gs^Fms, Gg, Rr, Rr, Rr, Ss, Ss, Gg, Rr, Wwg^Bw/, Wwg, Chw, Ch, Ss, Ss, Wwg, Gg, Wo, Wwg, Ss, Rr, Rr, Wo, Wo, Mm, Mm, Mm, Mm, Cfa, Mm, Gs^Fds, Wo, Gg, Gg, Kh^Vov, Ch, Gg, Gg, Gg, Mm
Wo, Wo, Wo, Wo, Wo, Wo, Mm, Gg, Rr^Vhc, Rr, Gg, Rr, Rr, Rr, Hh^Fds, Hh^Fds, Rr^Vhc, Rr, Gg, Gd^Fetd, Gs^Fms, Gs^Fms, Gll^Fmf, Gs^Fms, Rr, Gd^Edb, Gd^Edb, Rr, Rr, Rr, Gg, Gg, Wo, Gg, Rr, Gg, Gg, Gg, Gs^Fds, Gg, Rr, Wwg^Bw/, Wo, Wo, Gs^Fds, Mm, Mm, Mm, Mm, Kfa, Mm, Mm, Mm, Wo, Gg, Ch, Ch, Ch, Gg, Gg, Mm, Mm
Wo, Wo, Wo, Wo, Wo, Wo, Wo, Wo, Wo, Wo, Wo, Mm, Mm, Gg, Wo, Wo, Wo, Rr, Wo, Wo, Wo, Gs^Fms, Ss, Gs^Fms, Gg, Rr, Rr, Gd, Gs^Vh, Gg, Ss, Wo, Gg, Gg, Rr, Gg, Gg, Gs^Fds, Gg, Gg, Rr, Rr, Rr, Gs^Fds, Gg, Mm, Mm, Mm, Mm, Mm, Mm, Mm, Mm, Wo, Wo, Gg, Gg, Rr, Gg, Gg, Gg^Fp, Gg
Wo, Wo, Wo, Wo, Wo, Wo, Wo, Wo, Wo, Wo, Mm, Wo, Wo, Wo, Gg, Gg, Gg, Wo^Bw|, Gg, Gg, Ss, Wo, Ss, Ss, Wo, Gg, Gd, Rr, Rr, Ss, Gg, Wo, Wo, Gg, Hhd^Edb, Rr^Edt, Rr^Edt, Hhd^Edb, Gg, Rr^Vhc, Rr, Gg, Gg, Rr, Rr, Mm, Mm, Mm, Mm, Mm, Mm, Mm, Gs^Fds, Gs^Fds, Wo, Gg, Gg, Rr, Gg, Gg^Fp, Gg^Fp, Gg
Wo, Wo, Wo, Wo, Wo, Wo, Wo, Wo, Wo, Wo, Wo, Wo, Wo, Wo, Hh, Hh^Fds, Hh^Fds, Rr, Gg, Gd^Fetd, Gs^Fms, Wo, Wo, Wo, Gg^Gvs, Gg^Gvs, Gg^Gvs, Gd, Gg, Rr, Rr, Gg, Gg, Wo, Gg^Edt, Gd^Edt, Gd^Edt, Rr^Edt, Rr, Rr, Wo, Wo, Gs^Fds, Gg, Rr, Gg, Hh, Gs^Fds, Gs^Fds, Gs^Fds, Gs^Fds, Mm, Gs^Fds, Gs^Fds, Gg, Wo, Wo^Bw/, Rr, Wo, Gg^Fp, Wo, Gg
Wo, Wo, Wo, Wo, Wo, Wo, Wo, Wo, Wo, Wo, Wo, Wo, Wo, Wo, Gg, Gg, Rr, Rr, Gll^Feth, Gs^Fms, Gll^Fdf, Gll^Fmf, Gll^Ftr, Ss, Gs^Fms, Gg^Gvs, Gs^Fms, Gg, Gs^Fms, Gg, Rr, Gg, Wo, Wo, Gg, Gg^Edt, Gg, Hhd^Edb, Rr, Wo, Ker, Cer, Gg, Gg, Gg, Rr^Es, Rr^Es, Gg, Rr^Es, Rr^Es, Rr^Es, Gg, Gg, Gg, Rr, Rr, Gg, Wo, Gg, Wo, Gg, Wo
Wo, Wo, Wo, Wo, Ha, Wo, Ha, Wo, Wo, Wo, Wo, Wo, Wo, Wo, Rr^Vhc, Rr, Gg, Gg, Gg, Gll^Fmf, Gll^Ftr, Gg^Fet, Cvr, Gs^Fms, Gs^Fms, Gs^Fms, Gs^Fms, Gg, Gg, Gg, Gg, Rr, Rr, Gg, Ch, Gg, Ch, Rr, Gg, Wo, Gd^Edt, Gg, Gs^Fds, Gg, Mm, Hh, Hh^Es, Rr, Uu^Vud, Gg, Gg, Rr, Rr, Rr, Gg, Gg, Gs^Fds, Gg, Gg^Fp, Gg^Fp, Gg^Fp, Gg
Wo, Wo, Wo, Mm^Xm, Wo, Wo, Wo, Wo, Wo, Mm^Fpa, Wo, Mm, Wo, Wo, Gg, Rr, Gg, Gg, Gg, Gll^Fdf, Gs^Fms, Gs^Fms, Gs^Fms, Kvr, Gll^Ftr, Gg^Fet, Gs^Fms, Gg, Gs^Fms, Gd, Gd, Gg, Gg, Rr, Ch, Kh^Vov, Ch, Gg, Gg, Wo, Gg, Gg, Gs^Fds, Gg, Mm, Mm, Hh^Es, Rr, Gg, Mm, Mm, Gg, Rr, Rr^Vhc, Gg, Gg, Hh, Hh^Fds, Mm, Gg^Fp, Mm, Mm
Wo, Wo, Wo, Wo, Ha^Fpa, Mm, Chw, Wo, Rb, Rb^Fpa, Wwg, Wwg, Wwg, Wwg, Gg, Rr, Rr, Gg, Gll^Fmf, Gll^Fdf, Gs^Fms, Gs^Fms, Gs^Fms, Gg^Fet, Gs^Fms, Gs^Fms, Wo, Ss, Gll^Fdf, Gs^Fms, Gs^Fms, Gd, Gg, Gg, Gg, Gg, Wwg^Bw|, Wwg, Wo, Wo, Gg, Gs^Fds, Gg, Mm, Mm, Hh, Hh^Es, Rr^Es, Hh^Es, Mm, Mm, Mm, Mm^Es, Rr, Rr, Gg, Gs^Fds, Hh^Fds, Mm, Mm, Mm, Mm
Wo, Wo, Wo, Ms, Rb, Ms, 7 Kh^Vov, Ch, Rb^Bw\, Rb^Fpa, Wwg, Wwg, Mm^Xm, Wwg, Wwg, Gg, Rr, Gs^Vh, Gg, Gg, Gll^Fdf, Gll^Ftr, Gll^Fmf, Gs^Fms, Gll^Fmf, Gll^Ftr, Ss, Wo, Gs^Fms, Gll^Fdf, Gs^Fms, Gg, Gs^Fms, Gg, Ss, Wwg, Rr, Gg, Gg, Gg, Gg, Gs^Fds, Gs^Fds, Mm, Mm, Mm, Cf, Rr^Es, Hh, Mm, Gg, Mm, Gg, Mm, Gg, Rr, Gg, Hh, Gg^Fp, Mm, Mm, Mm
Wo, Wo, Wo, Ms^Fpa, Rb^Fpa, Ch, Chw, Mm, Rb, Wwg, Wwg, Wwg, Wwg, Wwg, Wwg, Hh, Hh, Rr, Rr, Gg, Gg, Gll^Fdf, Gs^Fms, Gll^Fmf, Gll^Fdf, Gll^Fdf, Ss, Wwg, Gg, Gs^Fms, Gg, Gg, Gg, Gg, Gg, Wo, Rr, Gg, Gd, Gs^Fds, Gg, Gg, Gs^Fds, Mm, Mm, Mm, 3 Kf^Vov, Rr^Es, Rr, Hh, Rr^Es, Rr, Rr, Gg, Gg, Rr, Gg, Gg, Gg, Gg^Fp, Gg^Fp, Mm
Wo, Wo, Wo, Wo, Wo, Rb^Fpa, Wo, Rb^Fpa, Wo, Mm, Wwg, Wwg, Wwg, Mm, Wwg, Wwg, Gg, Gg, Gg, Rr, Gg, Gg, Gg, Gs^Fms, Gg, Gg, Wo, Wwg, Gg, Gg, Gg, Gg, Gs^Fms, Gg, Rr, Wwg^Bw/, Gg, Gd, Gd, Gg, Wwg, Wwg, Mm, Mm, Mm, Cf, Cf, Mm, Mm, Rr, Hh, Gg, Rr^Vhc, Rr, Rr, Rr, Rr, Gg, Rr, Rr^Vhc, Gg, Gg
Wo, Wo, Wo, Ha, Wo, Wo, Wo, Wo, Ms, Wo, Wo, Mm^Xm, Wo, Wwg, Wo, Wo, Ch, Gg, Ch, Rr, Rr, Gg, Rr, Gg, Wo, Wo, Gg, Gg, Gll^Fdf, Gs^Fms, Gg, Rr^Vhc, Rr, Rr, Wwg, Wo, Wo, Gg, Wo, Wwg, Gg, Gg, Mm^Es, Mm, Mm, Mm, Mm, Mm, Mm, Mm^Es, Gg, Wwg, Wwg, Gg, Gg, Gg, Gg, Rr, Gg, Gg, Wwg, Wwg
Wo, Wo, Wo, Wo, Mv, Ha, Mm^Fpa, Ha, Wo, Wo, Wo, Wo, Wo, Wo, Wo, Wo, Gg, Kh^Vov, Ch, Gg, Gg, Rr, Gg, Rr, Wo^Bw\, Gg, Gg, Gs^Fms, Gg, Gg, Rr, Rr, Gg, Ch, Wwg, Ch, Gg, Wo, Gg, Gg, Gg, Gg, Gs^Fds, Mm^Es, Gs^Fds, Mm, Mm, Mm, Mm, Mm, Mm, Gg, Wo, Gg, Ch, Gg, Gg, Rr, Ch, Wwg, Wo, Wo
Wo, Wo, Wo, Wo, Wo, Ha, Wo, Wo, Wo, Wo, Wo, Wo, Wo, Wo, Wo, Wo, Wo, Ch, Gg, Gg, Gg, Gg, Wwg, Gg, Wo, Rr, Rr, Gg, Rr, Rr, Gg, Gg, Gs^Vc, Wo, Ss, Gg, Gg, Gg, Gg, Gg, Gg, Gs^Fds, Gs^Fds, Gs^Fds, Gs^Fds, Gs^Fds, Gg, Mm, Mm, Mm, Mm, Gg, Gg, Wo, Wo^Bw/, Rr, Rr, Rr, Wwg, Wwg, Wo, Wwg
Wo, Wo, Wo, Wo, Wo, Wo, Wo, Wo, Wo, Wo, Wo, Wo, Wo, Wo, Wo, Wo, Wo, Wwg, Wwg, Gg, Wwg, Wwg, Wo, Wo, Wwg, Gg, Gg, Rr, Rr^Vhc, Gg, Ss, Gg, Wo, Wo, Wo, Wwg, Wwg, Gg, Wwg, Ss, Ss, Gg, Gg, Gs^Fds, Gg, Gg, Gg, Gg, Ch, Gg, Rr, Gg, Rr, Rr, Wo, Ch, Wo, Ww^Ewf, Wwg, Wo, Wwg, Wwg
Wo, Wo, Wo, Wo, Wo, Wo, Wo, Wo, Wo, Wo^Edt, Wo, Wo, Wo, Wo, Wo, Wo, Wo, Wo, Wo, Wwg, Wo, Wo, Wwg, Wo, Wo, Wwg, Ch, Rr, Ch, Gg, Wwg, Wwg, Wo, Wwg, Wwg, Wo, Wo, Wwg, Wo, Wo, Wwg, Ss, Wwg, Gg, Wwg, Gg, Ww^Ewf, Gg, Wwg, Rr, Wwg, Rr, Wwg, Wo, Wwg, Wo, Wwg, Ww^Ewf, Wwg, Wwg, Gg, Gg
Wo, Wo, Wo, Wo, Wo, Wo, Wo, Wo, Wo^Edt, Wo, Wo, Wo, Wo, Wo, Wo, Wo, Mm, Wwg, Wwg, Wo, Wwg, Wwg, Hh, Wwg, Gg, Wo, Wwg, Rr, Wwg, Wwg, Wo, Wo, Wwg, Ww^Ewf, Gg, Wwg, Wwg, Wo, Wwg, Ss, Ss, Wwg, Wwg, Wwg, Wo, Wwg, Wo, Ww^Ewf, Wo, Wo^Bw|, Wo, Wo, Wo, Wo, Ww^Ewf, Ww^Ewf, Hh, Ww^Ewf, Gg, Gg, Mm, Gg
Wo, Wo, Wo, Wo, Wo, Wo, Wo, Wo^Edt, Qxe, Wo^Edt, Wo, Wo, Wo, Wo, Wo, Mm, Gg, Gg, Ch, Wwg, Gg, Hh, Gg, Gg, Gg, Wwg, Ch, Wwg^Bw|, Wo, Wo, Ss, Ss, Ss, Ss, Gg^Fds, Gg, Gg, Wwg, Gg, Gg, Wwg, Wo, Wo, Wo, Wwg, Wo, Ss, Wo, Wo, Rr, Ch, Wwg, Wwg, Wwg, Gg, Hh, Gs^Vh, Gg, Gg, Gg, Mm, Gg
Wo, Wo, Wo, Wo, Wo, Wo, Wo, Wo^Edt, Wo^Edt, Wo^Edt, Wo, Wo, Wo, Wo, Wo, Wwg, Gg, Ch, Kh^Vov, Gg, Gg, Gg, Gll^Fmf, Gg, Gs^Fds, Gg, Rr, Rr, Wwg, Wwg, Gg, Gg, Gg, Gg, Gg, Gg, Cer, Gg, Hh^Edb, Gg, Gg, Wwg, Ww^Ewf, Wwg, Gg, Ss, Gg, Gg, Wo, Rr, Gg, Gg, Gs^Fds, Gs^Fds, Gs^Fds, Gg, Gg, Gg, Hh, Mm, Mm, Mm
Wo, Wo, Wo, Wo, Wo, Wo, Wo, Wo, Wo, Wo, Wo, Wo, Wo, Wo, Wo, Wwg, Hh, Gg, Ch, Ch, Rr, Gg, Gg, Gs^Fds, Gs^Fds, Gg, Rr, Gg, Gg, Gg, Hh, Gg, Gs^Fds, Gs^Fds, Hh^Fds, Hh^Edb, 9 Ker, Hh^Edb, Hh^Edb, Gg, Gg^Fp, Gs^Vh, Gg, Gg, Wo, Gg, Gg, Gg, Wo, Rr, Rr^Vhc, Gg, Gs^Fds, Gs^Fds, Gs^Fds, Gs^Fds, Gg, Hh, Mm, Mm, Mm, Mm
Wo, Wo, Wo, Wo, Wo, Wo, Wo, Wo, Wo, Wo, Wo, Wo, Wo, Wo, Wo, Wwg, Wo, Gg, Rr, Gg, Gs^Fds, Rr, Rr, Gs^Fds, Rr, Rr, Gs^Vc, Gg, Hh, Gll^Fmf, Hh^Fds, Hh, Hh, Hh, Hh, Hh^Edb, Mm^Fp, Hh^Fp, Mm^Fp, Hh^Fp, Mm, Gg, Gg, Gg, Wo, Wo, Wo, Wo, Wo, Rr, Rr, Gs^Fds, Gs^Fds, Gs^Fds, Mm, Gs^Fds, Gs^Fds, Gg, Mm, Mm, Mm, Mm
Wo, Wo, Wo, Wo, Wo, Wo, Wo, Wo, Wo, Wo, Wo, Wo, Wo, Wo, Wo, Wo, Wo, Wo, Gs^Fds, Rr, Gg, Hh, Hh, Rr, Rr, Gg, Gg, Hh, Gs^Fds, Hh^Fds, Hh, Hh, Mm, Hh, Mm, Mm, Mm, Mm^Fp, Mm, Mm, Mm, Mm, Mm, Gg, Gg, Gg, Gg, Gg, Wo, Gg, Rr, Hh^Fds, Hh, Mm, Mm, Mm, Gs^Fds, Gg, Gg, Mm, Mm, Mm
Wo, Wo, Wo, Wo, Wo, Wo, Wo, Wo, Wo, Wo, Wo, Wo, Wo, Wo, Wo, Wo, Hh, Wo, Wo, Rr, Rr, Gg, Gs^Fds, Rr, Gg, Rr, Rr, Gg, Gs^Fds, Hh, Mm, Mm, Mm, Mm, Mm, Mm, Mm, Mm, Mm, Mm, Mm, Mm, Mm, Mm, Mm, Mm, Mm, Gg, Wo, Gg, Rr, Hh, Mm, Mm, Mm, Gs^Fds, Gg, Gg, Hh, Gs^Fds, Gg, Mm
Wo, Wo, Wo, Wo, Wo, Wo, Wo, Wo, Wo, Wo, Wo, Wo, Wo, Wo, Wo, Wo, Wo, Wo, Wo, Hh, Rr, Hh, Rr, Rr, Gg, Gg, Gg, Rr, Gg, Gs^Vc, Hh, Mm, Mm, Mm, Mm, Mm, Mm, Mm, Mm^Es, Mm^Es, Mm, Mm, Hh, Mm, Mm, Mm, Mm, Mm, Rr, Wo^Bw/, Mm, Mm, Mm, Mm, Gg, Gg, Hh, Gg, Gs^Fds, Hh, Gg, Gg
Wo, Wo, Wo, Wo, Wo, Wo, Wo, Wo, Wo, Wo, Wo, Wo, Wo, Wo, Hh, Wo, Gg, Wo, Gg, Rr^Vhc, Gg, Rr, Gg, Gg, Gg^Fp, Gg^Fp, Hh, Rr, Hh, Gg, Hh, Mm, Mm, Mm, Mm, Mm, Mm, Mm, Mm, Mm^Es, Hh, Hh, Mm, Hh, Hh, Wo, Wo, Wo, Wo^Bw|, Wo, Gg^Em, Mm, Gg, Mm, Hh, Gg, Gg, Mm, Mm, Gs^Fds, Gg, Gg
Wo, Wo, Wo, Wo, Wo, Wo, Wo, Wo, Wo, Wo, Wo, Wo, Wo, Wo, Wo, Wo, Hh, Wo, Gg, Gg, Gs^Fds, Gg, Gg^Fp, Gg, Gg^Fp, Hh^Fp, Hh^Fp, Rr, Rr, Hh, Hh, Hh, Mm, Mm, Mm, Mm, Mm, Mm, Mm, Mm, Hh, Hh, Mm, Mm, Mm, Hh, Hh, Gg, Rr, Gg^Ve, Rr, Rr, Rr, Gg^Em, Gg^Emf, Hh, Gg, Gg, Mm, Gs^Fds, Gg, Gg
Wo, Wo, Wo, Wo, Wo, Wo, Wo, Wo, Wo, Wo, Wo, Wo, Wo, Wo, Wo, Wo, Wo, Wo, Wo, Wo, Gg, Gg, Gg, Hh^Fp, Hh^Fp, Hh^Fp, Hh, Gg, Rr, Hh, Gg, Ss, Ss, Mm, Mm, Mm, Mm, Kfa, Kha, Hh, Hh, Mm, Mm, Mm, Mm, Mm, Mm, Rp, Wwg, Rr, Wwg, Wo, Wo, Rr, Rr, Gg, Gg, Gg^Wm, Gg, Mm, Mm, Gg
Wo, Wo, Wo, Wo, Wo, Wo, Wo, Wo, Wo, Wo, Wo, Wo, Wo, Wo, Wo, Wo, Wo, Wo, Gg, Wo, Wo, Gg, Hh, Hh, Hh, Hh, Hh^Es, Gg, Gg, Rr, Gg, Ss, Ss, Gg, Gg, Mm, Mm, Mm, Hh, Hh, Gs^Fds, Gg, Gg, Mm, Mm, Mm, Mm, Wwg, Hh, Wwg, Hh, Gg^Em, Wo, Gg, Gg, Rr, Cv, Gg, Hh, Gg, Gg, Gg
Wo, Wo, Wo, Wo, Wo, Wo, Wo, Wo, Wo, Wo, Wo, Wo, Wo, Wo, Wo, Wo, Wo, Wo, Wo, Wo, Wo, Gg, Gg, Hh, Hh, Hh, Hh^Es, Gg, Gg, Rr, Gg, Gg, Gg, Gg, Gg, Gg, Gg, Mm, Mm, Hh, Hh^Fms, Gg, Gg, Gs^Fds, Gg, Mm, Rp, Rp, Gs^Fds, Gs^Fds, Hh, Gg^Em, Gg^Em, Wo, Gg, Gg, 2 Kv^Vov, Gg^Emf, Gg, Hh, Gg, Gg
Wo, Wo, Wo, Wo, Wo, Wo, Wo, Wo, Wo, Wo, Wo, Wo, Wo, Wo, Wo, Hh, Wo, Wo, Wo, Wo, Hh, Wo, Wo, Gg, Gg, Hh, Gll, Gg, Gg, Rr, Rr, Gg, Gg, Wo, Wo, Gg, Gg, Gg, Mm, Hh^Fms, Hh^Fms, Gs^Fds, Gs^Fds, Gg, Rp, Rp, Mm, Mm, Mm, Gs^Fds, Mm, Mm, Gg, Wo, Wwg, Cv, Gg, Cv, Rr, Gg, Mm, Gg
Wo, Wo, Wo, Wo, Wo, Wo, Wo, Wo, Wo, Wo, Wo, Wo, Wo, Wo, Wo, Wo, Wo, Wo, Wo, Wo, Wo, Wo, Gg, Gg, Gg, Hh, Gg, Gll, Gll, Gg, Gg, Rr, Rr, Gg, Gg, Wo, Wo, Gg, Mm, Mm, Mm, Hh^Fms, Gs^Fds, Rp, Gg, Mm, Mm, Mm, Mm, Mm, Mm, Mm, Mm, Gg, Gg, Wwg, Gg, Gg, Rr, Gg^Emf, Mm, Gg
Wo, Wo, Wo, Wo, Wo, Wo, Wo, Wo, Wo, Wo, Wo, Wo, Wo, Wo, Wo, Wo, Wo, Wo, Wo, Wo, Gg, Wo, Gg, Gg, Gg, Gg, Gs^Fds, Gs^Fds, Gll, Gg, Gg, Gg, Gg, Rr, Gg, Gg, Wo, Gg, Gg, Mm, Mm, Hh, Gs^Fds, Rp, Gg, Mm, Mm, Mm, Mm, Mm, Mm, Mm, Mm, Gg, Wo, Wo, Gg, Rr, Hh, Gg^Wm, Mm, Mm
Wo, Wo, Wo, Wo, Wo, Wo, Wo, Wo, Wo, Wo, Wo, Wo, Wo, Wo, Wo, Wo, Wo, Wo, Wo, Wo, Wo, Wo, Wo, Gg, Gg, Gll^Fmf, Gs^Fds, Gs^Fds, Gll^Fmf, Gll, Gg, Gg, Gg, Rr, Gg, Gg, Gg, Wo, Wo, Gg, Mm, Gs^Fds, Gs^Fds, Rp, Gg, Mm, Mm, Mm, Mm, Mm, Mm, Mm, Mm, Gg, Wo, Ss, Hh, Rr, Rr, Gg, Gg, Mm
Wo, Wo, Wo, Wo, Wo, Wo, Wo, Wo, Wo, Wo, Wo, Wo, Wo, Wo, Wo, Wo, Wo, Wo, Wo, Wo, Wo, Wo, Hh, Hh, Gg, Gs^Fds, Gs^Fds, Gs^Fds, Gs^Fds, Gll, Gg, Gg, Gg, Rr, Rr, Gg, Gg, Gg, Wo, Gg, Hh, Gg, Gs^Fds, Rp, Gg, Gs^Fds, Hh, Mm, Mm, Mm, Mm, Mm, Hh, Gg, Gg, Wwg, Wwg, Gg, Gg, Rr, Gg, Mm
Wo, Wo, Wo, Wo, Wo, Wo, Wo, Wo, Wo, Wo, Wo, Wo, Wo, Wo, Wo, Wo, Wo, Wo, Wo, Wo, Wo, Wo, Wo, Hh, Gg, Ker, Cer, Gs^Fds, Gg, Gg, Gg, Gs^Fds, Gs^Fds, Gg, Gg, Rr, Rr, Gg, Wwg, Gg, Gs^Fds, Gg, Gg, Rp, Gs^Fds, Gg, Hh, Hh^Es, Hh^Es, Hh, Hh^Fds, Mm^Fds, Hh^Fds, Hh, Gg^Fds, Ss, Wo, Gg, Hh, Rr, Hh, Mm
Wo, Wo, Wo, Wo, Wo, Wo, Wo, Wo, Wo, Wo, Wo, Wo, Wo, Wo, Wo, Wo, Wo, Wo, Wo, Wo, Wo, Wo, Wo, Wo, Wwg, Gg, Gg, Gg, Gg, Gg, Gg, Gs^Fds, Gll^Fmf, Gll, Gg, Gg, Gg, Rr, Wwg^Bw\, Gg, Gg, Gg, Gg, Rp, Gg, Gg, Hh, Hh, Hh^Es, Hh, Hh^Fds, Hh^Fds, Hh^Fds, Gg^Fds, Gg^Fds, Gg, Hh, Wo, Hh, Rr, Hh, Mm
Wo, Wo, Wo, Wo, Wo, Wo, Wo, Wo, Wo, Wo, Wo, Wo, Wo, Wo, Wo, Wo, Wo, Wo, Wo, Wo, Wo, Wo, Wo, Wo, Wwg, Gg, Gg, Gg, Gs^Fds, Gs^Fds, Gg, Gg, Gg, Gll, Gg^Gvs, Gg^Gvs, Gg^Gvs, Gg, Wwg, Ch, Kh, Gg, Rp, Rp, Gg, Hh, Hh, Gg, Gg, Cer, Ker, Hh^Fds, Gg^Fds, Gg^Fds, Gg^Fds, Hh, Hh, Wo, Gg, Rr, Hh, Mm
Wo, Wo, Wo, Wo, Wo, Wo, Wo, Wo, Wo, Wo, Wo, Wo, Wo, Wo, Wo, Wo, Wo, Wo, Wo, Wo, Wo, Wo, Wo, Wo, Wwg, Hh, Hh, Gg, Gs^Fds, Gll^Fmf, Gg, Gg, Gs^Fds, Gg^Gvs, Gg^Gvs, Gg^Gvs, Gg^Gvs, Gg, Wo, Ch, Ch, Ch, Rr, Gg, Gg, Hh, Gg, Gg, Gg, Gg, Wo, Gg, Wwg, Gg, Ss, Gg^Fds, Gg, Wo, Gg, Rr, Gg, Mm
Wo, Wo, Wo, Wo, Wo, Wo, Wo, Wo, Wo, Wo, Wo, Wo, Wo, Wo, Wo, Wo, Wo, Wo, Wo, Wo, Wo, Wo, Wo, Wo, Wwg, Hh, Hh, Gg, Gg, Gg, Gg, Gg, Gs^Fds, Gg, Gg^Gvs, Gg^Gvs, Gg, Gg, Gg, Wo, Wo, Gg, Gg, Rr, Rr, Gg, Wo, Wo, Wo, Wo, Gg, Wo, Ss, Wwg, Wo, Wo, Wo, Wo, Gg, Rr, Gg, Mm
Wo, Wo, Wo, Wo, Wo, Wo, Wo, Wo, Wo, Wo, Wo, Wo, Wo, Wo, Wo, Wo, Wo, Wo, Wo, Wo, Wo, Wo, Wo, Wo, Gg, Wwg, Gg, Gg, Gd, Gd, Gd, Gg, Gll^Fmf, Gg, Gg, Gg, Gs^Fds, Gs^Fds, Gg, Gg, Gg, Wo, Gg, Gg, Rr, Ss, Wo, Ss, Gg, Gg, Re, Re, Re, Gg, Gg, Gg, Gg, Gg, Rr, Rr, Gg, Mm
Wo, Wo, Wo, Wo, Wo, Wo, Wo, Wo, Wo, Wo, Wo, Wo, Wo, Wo, Wo, Wo, Wo, Wo, Wo, Wo, Wo, Wo, Wo, Wo, Wo, Wwg, Wwg, Gg, Gg, Gd, Gs^Fds, Gs^Fds, Gs^Fds, Gs^Fds, Gg, Gg, Gg, Gs^Fds, Gg, Gg, Gg, Wo, Ss, Gg, Gg, Rr, Wwg, Gg, Re, Re, Hh, Hh, Re, Re, Hh, Hh, Rr, Rr, Gg^Ve, Gg, Gg, Mm
Wo, Wo, Wo, Wo, Wo, Wo, Wo, Wo, Wo, Wo, Wo, Wo, Wo, Wo, Wo, Wo, Wo, Wo, Wo, Wo, Wo, Wo, Wo, Wo, Wo, Wo, Wo, Gg, Hh, Gg, Gg, Gg, Gg, Gg, Hh, Hh, Gd, Gd, Gg, Gg, Wo, Wo, Wo, Wo, Wwg, Wwg^Bw|, Gg, Gg, Re, Re, Re, Re, Re, Re, Rr, Rr, Gs^Fds, Gg, Gg^Fds, Gg, Gg, Mm
Wo, Wo, Wo, Wo, Wo, Wo, Wo, Wo, Wo, Wo, Wo, Wo, Wo, Wo, Wo, Wo, Wo, Wo, Wo, Wo, Wo, Wo, Wo, Wo, Wo, Wo, Wwg, Hh, Hh, Hh, Gg, Gg, Gg, Hh, Gg, Gd, Gd, Gd, Gs^Fds, Gg, Wo, Gg, Gg, Gg, Gg, Rr, Gg, Gg, Gg, Re, Rr, Gg, Rr, Rr, Gg, Gg, Gs^Fds, Gs^Fds, Gg^Fds, Gg, Mm, Mm
Wo, Wo, Wo, Wo, Wo, Wo, Wo, Wo, Wo, Wo, Wo, Wo, Wo, Wo, Wo, Wo, Wo, Wo, Wo, Wo, Wo, Wo, Wo, Wo, Wo, Wwg, Wwg, Wwg, Gg, Gg, Gs^Fds, Gg, Gg, Gg, Gs^Fds, Gs^Fds, Gg, Gg, Gs^Fds, Gg, Wo, Ss, Re, Re, Re, Rr, Rr, Rr^Vhc, Rr, Rr, Hh, Rr, Gg, Gg, Hh, Hh, Mm, Gs^Fds, Mm, Mm, Mm, Mm
Wo, Wo, Wo, Wo, Wo, Wo, Wo, Wo, Wo, Wo, Wo, Wo, Wo, Wo, Wo, Wo, Wo, Wo, Wo, Wo, Wo, Wo, Wo, Wo, Wo, Gg, Hh, Gg, Gg, Gg, Gll^Fmf, Gg, Gg, Gll^Fmf, Gs^Fds, Gg, Gd, Gg, Gll^Fmf, Gg, Wo, Ss, Re, Re, Re, Gg, Gg, Rr, Gg, Hh, Gg, Gg, Gg^Fds, Hh^Fds, Hh, Mm, Mm, Mm, Mm, Mm, Mm, Mm
Wo, Wo, Wo, Wo, Wo, Wo, Wo, Wo, Wo, Wo, Wo, Wo, Wo, Wo, Wo, Wo, Wo, Wo, Wo, Wo, Wo, Wo, Wo, Wo, Wo, Wo, Wo, Wo, Hh, Gs^Fds, 8 Ke^Vov, Ce, Gg, Gll^Fmf, Gd, Gd, Gd, Gd, Gll^Fmf, Gg, Gg, Wo, Gg, Re, Gg^Fds, Gg^Fds, Gg, Rr, Gg, Gg, Gg^Fds, Gg^Fds, Gs^Fds, Hh^Fds, Mm, Mm, Mm, Mm, Mm, Mm, Mm, Mm
Wo, Wo, Wo, Wo, Wo, Wo, Wo, Wo, Wo, Wo, Wo, Wo, Wo, Wo, Wo, Wo, Wo, Wo, Wo, Wo, Wo, Wo, Wo, Wo, Wo, Wo, Wo, Wo, Hh, Gs^Fds, Ce, Ce, Gg, Gg, Hh^Esd, Hh, Hh^Fds, Gd, Gd, Gg, Ss, Ww, Ss, Gg, Gg, Gs^Fds, Gg, Rr, Gg, Gg, Gg^Fds, Gs^Fds, Gs^Fds, Hh^Fds, Hh, Mm, Mm, Mm, Mm, Mm, Mm, Mm
Wo, Wo, Wo, Wo, Wo, Wo, Wo, Wo, Wo, Wo, Wo, Wo, Wo, Wo, Wo, Wo, Wo, Wo, Wo, Wo, Wo, Wo, Wo, Wo, Wo, Wo, Wo, Wo, Wo, Gg, Gg, Gg, Gs^Fds, Gg, Hh^Esd, Hh^Fds, Gd, Gd, Gg, Ss, Wo, Ww, Rd, Rd, Re, Hh, Re, Rr, Hh, Gg, Re, Gg, Gg, Gg, Gg^Esd, Hh, Gg, Gg, Gg, Gg, Gg, Gg
Wo, Wo, Wo, Wo, Wo, Wo, Wo, Wo, Wo, Wo, Wo, Wo, Wo, Wo, Wo, Wo, Wo, Wo, Wo, Wo, Wo, Wo, Wo, Wo, Wo, Wo, Wo, Wo, Wo, Wo, Wo, Gs^Fds, Gs^Fds, Gg, Gg, Gg, Gg, Ss, Ww, Wo, Rd, Rd^Fmf, Rd^Esd, Rd^Esd, Rd, Re, Re, Rr, Rr, Re, Re^Fmf, Re^Es, Re, Gg^Esd, Gg^Esd, Gg, Gg, Gg, Re, Re, Re, Gg
Wo, Wo, Wo, Wo, Wo, Wo, Wo, Wo, Wo, Wo, Wo, Wo, Wo, Wo, Wo, Wo, Wo, Wo, Wo, Wo, Wo, Wo, Wo, Wo, Wo, Wo, Wo, Wo, Wo, Wo, Wo, Wo, Wo, Gg, Gg, Gg, Wo, Ww, Gg, Gg, Rd, Rd^Esd, Rd^Esd, Rd^Fmf, Rd^Esd, Re^Esd, Re, Gg^Esd, Rr, Re, Re, Re^Es, Re^Es, Re, Ch, Gg, Ch, Gg, Re, Re, Re, Re
Wo, Wo, Wo, Wo, Wo, Wo, Wo, Wo, Wo, Wo, Wo, Wo, Wo, Wo, Wo, Wo, Wo, Wo, Wo, Wo, Wo, Wo, Wo, Wo, Wo, Wo, Wo, Wo, Wo, Wo, Wo, Wo, Wo^Esd, Wo, Wo, Wo, Gg, Ss, Gg^Fmf, Gg^Fmf, Hh, Rd, Rd, Rd, Re^Fmf, Re, Re^Fmf, Gg^Esd, Rr, Gg, Gg^Fmf, Re, Re^Es, Re, Ch, 1 Kh^Vov, Ch, Gg, Gg, Re, Re, Re
Wo, Wo, Wo, Wo, Wo, Wo, Wo, Wo, Wo, Wo, Wo, Wo, Wo, Wo, Wo, Wo, Wo, Wo, Wo, Wo, Wo, Wo, Wo, Wo, Wo, Wo, Wo, Wo, Wo, Wo, Wo, Wo, Wo, Gg, Gg, Gg^Fmf, Gg, Gg, Hh, Hh, Gg^Esd, Rd, Re, Re^Es, Re^Es, Re^Fmf, Re^Esd, Re, Re, Rr, Gg^Fmf, Gg^Fmf, Gg, Gg, Gg, Ch, Gg, Gg, Re, Re, Re, Re
Wo, Wo, Wo, Wo, Wo, Wo, Wo, Wo, Wo, Wo, Wo, Wo, Wo, Wo, Wo, Wo, Wo, Wo, Wo, Wo, Wo, Wo, Wo, Wo, Wo, Wo, Wo, Wo, Wo, Wo, Wo, Wo, Wo, Gg^Esd, Re, Re, Re, Gg, Gg, Hh, Gg, Rd, Re, Re, Re^Fmf, Re^Es, Re^Esd, Re^Esd, Re, Rr, Gg, Gg^Fmf, Rr, Gg, Rr, Rr, Hh, Hh, Re, Re, Re, Re
Wo, Wo, Wo, Wo, Wo, Wo, Wo, Wo, Wo, Rrc, Wo, Wo, Wo, Wo, Wo, Wo, Wo, Wo, Wo, Wo, Wo, Wo, Wo, Wo, Wo, Wo, Wo, Wo, Wo, Wo, Wo, Wo, Wo, Gg^Esd, Re, Re, Re, Gg, Gg, Gg, Gg, Rd, Rd, Re^Fmf, Re^Fmf, Re^Es, Re, Re, Rr^Vhc, Rr, Rr, Rr, Gg, Rr, Gg, Rr, Gg^Esd, Gg, Re^Fmf, Re^Fmf, Re, Re
Wo, Wo, Wo, Wo, Wo, Wo, Wo, Wo, Rd^Br/, Rd^Br/, Rd^Br\, Wo, Wo, Wo, Wo, Wo, Wo, Wo, Wo, Wo, Wo, Wo, Wo, Wo, Wo, Wo, Wo, Wo, Wo, Wo, Wo, Wo, Wo, Gll^Fmf, Re, Re, Re, Gg, Ch, Ch, Ch, Gg, Rd, Rd, Re, Re, Gg^Fmf, Gg, Rr, Rr, Gg, Gg, Re, Re, Re, Gg^Esd, Re, Gg, Re^Fmf, Re^Fmf, Wo, Wo
Wo, Wo, Wo, Wo, Wo, Wo, Rrc, Rd^Br/, Iwc, Iwc, Iwc, Rd^Br\, Rrc, Wo, Wo, Wo, Wo, Wo, Wo, Wo, Wo, Wo, Wo, Wo, Wo, Wo, Wo, Wo, Wo, Wo, Wo, Wo, Gg, Gll^Fmf, Re, Re, Re, Hh, Ch, Kh^Vov, Ch, Rr, Rr, Rd, Rr, Gg, Rr, Rr, Gg, Rr, Rr, Gg, Re, Re, Re^Fmf, Re, Wo, Wo, Wwg, Wo, Re, Gg
Wo, Wo, Wo, Wo, Wo, Wo, Wo, Rd^Br|, Rd^Br\, Iwc, Rd^Br/, Rd^Br|, Wo, Wo, Wo, Wo, Wo, Wo, Wo, Wo, Wo, Wo, Wo, Wo, Wo, Wo, Wo, Wo, Wo, Wo, Wo, Gg, Hh, Gg, Dd, Re, Rd, Hh, Gg, Gg, Rd, Gg, Rd, Rr, Hh, Rr, Re, Gg, Rd, Rd, Rr, Hh, Hh, Re^Fmf, Gd^Fts, Gd^Fts, Wo, Re, Re, Dd^Vda, Rr, Rr
Wo, Wo, Wo, Wo, Wo, Wo, Wo, Wo, Wo, Rd^Br\, Wo, Wo, Wo, Wo, Wo, Wo, Wo, Wo, Wo, Wo, Wo, Wo, Wo, Wo, Wo, Wo, Wo, Wo, Wo, Wo, Wo, Hh, Hh, Dd, Dd, Rd, Rd, Rd, Rd, Rd, Rd, Rd, Rd, Hh, Rd, Re, Re, Re, Rd, Rd, Rr, Gg, Rd, Re, Re, Re^Fmf, Wo, Re, Rr, Rr, Dd, Dd
Wo, Wo, Wo, Wo, Wo, Wo, Wo, Wo, Wo, Rrc, Wo, Wo, Wo, Wo, Wo, Wo, Wo, Wo, Wo, Wo, Wo, Wo, Wo, Wo, Wo, Wo, Wo, Wo, Wo, Wo, Wo, Gg, Wo, Gg, Rd, Rd, Rd, Rd, Rd, Gd^Fts, Dd, Rd, Rd, Rd, Gd^Fts, Re, Re^Es, Rd, Rd, Dd^Esd, Rr, Gg, Rd, Re, Wo, Wo, Dd^Ftd, Re, Rr, Dd, Dd, Dd
Wo, Wo, Wo, Wo, Wo, Wo, Wo, Wo, Wo, Wo, Wo, Wo, Wo, Wo, Wo, Wo, Wo, Wo, Wo, Wo, Wo, Wo, Wo, Wo, Wo, Wo, Wo, Wo, Wo, Wo, Wo, Wo, Wo, Wo, Gg, Rd, Dd, Dd, Rd, Rd, Gd^Fts, Gd^Fts, Gd^Fts, Gd^Fts, Dd^Es, Rd^Es, Rd, Rd, Rd^Esd, Rd, Hh, Rr, Rd, Rd, Wo, Dd, Dd^Vda, Dd^Esd, Rr, Dd^Esd, Dd, Dd
Wo, Wo, Wo, Wo, Wo, Wo, Wo, Wo, Wo, Wo, Wo, Wo, Wo, Wo, Wo, Wo, Wo, Wo, Wo, Wo, Wo, Wo, Wo, Wo, Wo, Wo, Wo, Wo, Wo, Wo, Wo, Wo, Wo, Wo, Dd, Rd, Dd, Dd, Dd, Dd, Dd, Gd^Fts, Dd^Ftd, Dd^Ftd, Dd^Ftd, Rd, Rd, Rd, Rd, Rd, Rd, Rr, Rr, Rd, Wwg, Rd, Rr, Rr, Dd^Ftd, Dd^Ftd, Dd, Dd
Wo, Wo, Wo, Wo, Wo, Wo, Wo, Wo, Wo, Wo, Wo, Wo, Wo, Wo, Wo, Wo, Wo, Wo, Wo, Wo, Wo, Wo, Wo, Wo, Wo, Wo, Wo, Wo, Wo, Wo, Wo, Wo, Wo, Dd, Dd, Dd, Dd, Dd, Dd, Dd, Dd, Dd, Dd, Dd^Ftd, Dd, Dd, Dd, Cdr, Kdr, Rd, Rd, Rd, Wo, Wwg^Bw\, Rr, Rr, Dd, Dd, Dd, Dd^Ftd, Dd, Dd
Wo, Wo, Wo, Wo, Wo, Wo, Wo, Wo, Wo, Wo, Wo, Wo, Wo, Wo, Wo, Wo, Wo, Wo, Wo, Wo, Wo, Wo, Wo, Wo, Wo, Wo, Wo, Wo, Wo, Wo, Wo, Wo, Wo, Dd, Gg, Dd, Dd, Dd, Dd, Dd, Dd, Dd, Dd, Dd, Rd, Dd, Dd, Dd, Rd, Dd, Dd, Wo, Dd, Dd, Dd, Rr, Rd, Dd, Rd, Dd, Gg, Gg
